0010 0010 0110 0111 0011 0110 0011 0110 0011 0000
1010 1010 1100 1111 1011 1110 1111 1011 1110 0001
1110 1111 0111 1111 1111 1111 1111 1101 1101 0001
1100 1011 1010 1110 1111 1111 1111 0111 0111 0001
0010 1000 1110 1101 1111 1011 1110 1111 1111 0001
1110 0101 1111 0111 1111 1111 1111 1111 1101 0011
1100 0111 1111 1111 1111 1111 1111 1111 0111 1011
0000 1100 1111 1111 1101 1101 1101 1111 1111 1011
0100 0011 1010 1110 0111 0101 0111 1011 1100 1011
0100 1101 1101 1101 1101 0101 1101 1101 0101 1001